NO ./assets/N.xpm
SO ./assets/N.xpm
WE ./assets/W.xpm
EA ./assets/W.xpm

F 220,100,0
C 225,30,0

      1111111111111111111
     10000S00000000000001
    10000000011111100001
11110000000000000010001
11111D10011D1100111101111
1000001001000100100000001
100000100D000D00000000011
11D111101100011111101111
11000011111D110000000001
110000001110110011100011
1111011001101100011100111
11000010011D1100100110001
1000000101101100000000001
1001000100000O00000000101
 1001001010011100001111101
  100100011D1100001   101
111D110001101100001111101
10000100011D1100000000001
1000011001100D00000000001
10000011D11D1100000000001
1000000000000000000000001
1000000000000000000000001
1111111111111111111111111
